NO ./path_to_the_north_texture
SO ./path_to_the_south_texture
WE ./path_to_the_west_texture
EA ./path_to_the_east_texture

F 220,100,0
C 225,30,0

 111 
11011
10N01
11011
 111 

1111111
1111101
1000001
100N101
1111111


111110
110111
11   1
1    1
1    1
111111
