
EA ./test/path_to_the_east_texture
WE ./somefolder/west_texture
SO ./path_to_the_south_texture
NO ./path_to_the_north_texture

F 10,10,10
C 220,220,220

11111111
10000001
1N000001
10010001
10000001
11111111
