NO ../test/textures/north.xpm
EA ../test/textures/east.xpm
WE ../test/textures/west.xpm
SO ../test/textures/south.xpm

F 25,50,50
C 25,120,120

    11111111111111
    111100000011111
    111101111011111
    1111011 1011111
    1110E01 1011111
    1110001 1011111
    1110001 1011
    111101111011111
    100000000000001
1111111111111111111
10000000001
11111111111
