F 194,178,128
C 135,206,235

NO ./test/textures/stone_wall.xpm
SO ./test/textures/stone_wall.xpm
WE ./test/textures/stone_wall.xpm
EA ./test/textures/stone_wall.xpm

B_D ./test/textures/door.xpm
B_X ./test/textures/enemy_lukas.xpm
B_A ./test/textures/ammo.xpm
B_T ./test/anims/torch/torch00.xpm ./test/anims/torch/torch01.xpm ./test/anims/torch/torch02.xpm ./test/anims/torch/torch01.xpm 
B_H ./test/textures/health_pack_red.xpm

111111111111111111111111111111
1T0T0T0T0T0T0T0T0T0T0T0T0T0T01
100000000000000000000000000001
1T0000000000000S000000000000T1
10A110000000000000000000011A01
1T01100000A00000000H00000110T1
100000000000000000000000000001
1T00000000000000000000000000T1
100000000000000000000000000001
1T00000111T00000000T11100000T1
1000000AT1T00000000T1TH0000001
1T00000001T00000000T10000000T1
10000H000000000000000000A00001
1T0000000T0000000000T0000000T1
10000000010H000000A01000000001
1T0T0000T1T0T0000T0T1T0000T0T1
11111D11111111DD11111111D11111
111111111111111111111111111111