F 194,178,128
C 135,206,235

NO ../test/textures/stonewall.xpm
SO ../test/textures/stonewall.xpm
WE ../test/textures/stonewall.xpm
EA ../test/textures/stonewall.xpm

B_D ../test/textures/door.xpm
B_X ../test/textures/enemy_lukas.xpm
B_T ../test/anims/torch/torch00.xpm ../test/anims/torch/torch01.xpm ../test/anims/torch/torch02.xpm ../test/anims/torch/torch03.xpm ../test/anims/torch/torch04.xpm ../test/anims/torch/torch05.xpm ../test/anims/torch/torch06.xpm ../test/anims/torch/torch07.xpm
B_H ../test/textures/health_pack_red.xpm

B_IMG_WIN ../test/textures/victory.xpm
B_IMG_LOSE ../test/textures/defeat.xpm
B_IMG_PISTOL ../test/textures/pistol.xpm
B_IMG_SHOT ../test/textures/pistol_shot.xpm

11111111111111111111111111111
10T0T0T0T0T0T0T0T0T0T0T0T0T01
1TA00E00000000000000000000HT1
1001110000000T1T0000000111001
1T0100000000000000000000010T1
10010H00000000000000000A01001
1T00000T0T000000000T0T00000T1
1000000111T0000000T1110000001
1T00000T010000A000010T00000T1
1000000AT1T0000000T1TA0000001
1T0000000000000000000000000T1
10000000000000000000000000001
1T000H00T1T0000000T1T00A000T1
10000000010H00000A01000000001
1T0T000T0100T000T0T10T000T0T1
11111D11111111D11111111D11111
1T0T000T0100T000T0T10T000T0T1
10000000010A00000H01000000001
1T000A00T1T0000000T1T00H000T1
10000000000000000000000000001
1T0000000000000000000000000T1
1000000AT1T0000000T1TA0000001
1T00000T010000H000010T00000T1
1000000111T0000000T1110000001
1T00000T0T000000000T0T00000T1
10010A00000000000000000H01001
1T0100000000000000000000010T1
1001110000000T1T0000000111001
1TH00000000000000000000X00AT1
10T0T0T0T0T0T0T0T0T0T0T0T0T01
11111111111111111111111111111