NO ./test/textures/north.xpm
SO ./test/textures/south.xpm
WE ./test/textures/west.xpm
EA ./test/textures/east.xpm

F 50,50,50
C 137,207,255

111111111111
100000000001
111000000001
101000000001
101000000001
101000000001
101000000001
10100DDD0001
101000000001
11101111D111
100000000001
100000000001
100000000001
100000000001
100000000001
100000000001
100000000001
100000000001
100000000001
100000000001
100000000001
100000000001
100000N00001
100000000001
111111111111
