F 194,178,128
C 135,206,235

NO ../test/textures/stonewall.xpm
SO ../test/textures/stonewall.xpm
WE ../test/textures/stonewall.xpm
EA ../test/textures/stonewall.xpm

B_D ../test/textures/door.xpm
B_X ../test/textures/enemy_lukas.xpm
B_A ../test/textures/ammo.xpm
B_T ../test/anims/torch/torch00.xpm ../test/anims/torch/torch01.xpm ../test/anims/torch/torch02.xpm ../test/anims/torch/torch01.xpm 
B_H ../test/textures/health_pack_red.xpm

B_IMG_WIN ../test/textures/victory.xpm
B_IMG_LOSE ../test/textures/defeat.xpm
B_IMG_PISTOL ../test/textures/pistol.xpm
B_IMG_SHOT ../test/textures/pistol_shot.xpm

1111111111111111111111111111111
1T000E000000XX00000000000000001
100000000000000H000000000000001
1T11110000000000000000000110001
1010000000000T11000000000H10001
101000000A00T11T001000000000001
1T10000000011000001000000A00001
101A000000000000001000000000001
1TD00000000000H0001000000000001
111111111D1111111111D1111111D11
1T00T0T0T0T0T0T0T10000001T000T1
1000000000000000010000001000001
100000A0000000000000000010000T1
10000000000000000H0000001000001
1001000H000000000000000010000T1
1001000000000T11000000001000001
10010000000000110000000010000T1
100000000T000000000000000000001
10000000000000000001100000000T1
1000000000000H0000011H000000001
10000A00000000000000000000000T1
1000000000111111110000000000001
10000000000000A00000000000000T1
1T0T0T0T0T0X00T0T0T0T0T0T0T0T01
1111111111111111111111111111111
