NO ./test/textures/stone_wall.xpm
SO ./test/textures/stone_wall.xpm
WE ./test/textures/stone_wall.xpm
EA ./test/textures/stone_wall.xpm

F 50,50,50
C 137,207,255

B_D ./test/textures/door.xpm
B_X ./test/textures/soldier.xpm
B_A ./test/textures/can.xpm
B_T ./test/textures/door.xpm ./test/textures/door.xpm ./test/textures/door.xpm

111111111111
100000000001
111000000001
101000000001
10100000X001
101000000001
101000000001
101000000001
101000000001
11101111D111
1000000000T1
100000000001
100000000001
100000000001
100000000001
100000000001
1000000000T1
100000000001
100000000001
100000000001
100000000001
100000000001
100000N00001
1000000000T1
111111111111