F 194,178,128
C 135,206,235

NO ./test/textures/stone_wall.xpm
SO ./test/textures/stone_wall.xpm
WE ./test/textures/stone_wall.xpm
EA ./test/textures/stone_wall.xpm


B_D ./test/textures/door.xpm
B_X ./test/textures/soldier.xpm
B_A ./test/textures/can.xpm
B_T ./test/anims/torch/torch00.xpm ./test/anims/torch/torch01.xpm ./test/anims/torch/torch02.xpm ./test/anims/torch/torch01.xpm 

111111111111
100000000001
111000000001
101000000001
101000000001
101000000001
101000000001
101000000001
101000000001
11101111D111
100000000001
100000000001
100000000001
100000000001
10000A000001
100000000001
100000000001
10000X000001
100000000001
100000000001
100000000001
100000000001
100000N00001
100000000001
111111111111