NO ./test/textures/stone_wall.xpm
SO ./test/textures/stone_wall.xpm
WE ./test/textures/stone_wall.xpm
EA ./test/textures/stone_wall.xpm

F 50,50,50
C 137,207,255

B_D ./test/textures/door.xpm
B_X ./test/textures/soldier.xpm
B_A ./test/textures/can.xpm
B_T ./test/anims/torch/torch00.xpm ./test/anims/torch/torch01.xpm ./test/anims/torch/torch02.xpm ./test/anims/torch/torch01.xpm 

111111111111
1000000000T1
1110000X0001
101000000A01
101000000001
101000000001
101000A00001
101A00000001
101000000001
11101111D111
100000000001
100000000001
100A00000001
100000000001
100000A00001
100000000001
100A00000001
100000000001
100000000001
10000000A001
100000000001
100000000001
100000N00001
100000000001
111111111111