F 194,178,128
C 135,206,235

NO ./test/textures/stone_wall.xpm
SO ./test/textures/stone_wall.xpm
WE ./test/textures/stone_wall.xpm
EA ./test/textures/stone_wall.xpm

B_D ./test/textures/door.xpm
B_X ./test/textures/enemy_lukas.xpm
B_A ./test/textures/ammo.xpm
B_T ./test/anims/torch/torch00.xpm ./test/anims/torch/torch01.xpm ./test/anims/torch/torch02.xpm ./test/anims/torch/torch01.xpm 

1111111111111111111111111111111
1000000000000000000000000000001
1000N00000000000000000000000001
1011110000000000000000000110001
1010000000000011000000000010001
101000000A000110001000000000001
1010000000011000001000000A00001
101A000000000000001000000000001
10D0000000000000001000000000001
111111111D1111111111D1111111D11
1000000000000000010000001000001
1000000000000000010000001000001
100000A000000000000000001000001
1000000000000000000000001000001
1001000000000000000000001000001
1001000000000011000000001000001
1001000000000011000000001000001
100000000T000000000000000000001
1000000000000000000110000000001
1000000000000000000110000000001
10000A0000000000000000000000001
1000000000111111110000000000001
10000000000000A0000000000000001
10000000000X0000000000000000001
1111111111111111111111111111111
