NO ./north.xpm
SO ./south.xpm
WE ./west.xpm
EA 101111.xpm

F 194,178,10
C 135,206,235

111111111111111
100000000000001
100000001111101
100000001   101
100000001   101
1000E0001   101
100000001111101
100000000000001
111101111111111